name:startdoor1
minMonLevel:15
mons:[]
startingPosition:35,18
doors:{"36,17":"start","36,18":"start","36,19":"start"}
1111111111111111111111111111111111110
1000000000000100000000010000000000010
1111111111111111111111110111111111110
1111111111111111000000011100000000010
1110000000011111000001110000000000010
1000000000000100000000010101010101010
1011100001110100000000010101010101010
1000000000000110000000110101010101010
1111100001111110000000110101010101010
1111100001111110000000110000000000010
1111100001111110000000111111000011110
1000100001000110000000110001000010010
1111100001111100000000011111000011110
1101100000110000000000001101000001010
1000000000000000000000000000000000010
1111111111111100000000011111111111110
1000000000000100000000010000000000010
1111111111111100000000011111111111110
1111100001101100000000010000000000010
1111000000111100000000010000000000010
1100100100100000000000000000000000010
1110110110110100000000010000000000010
1000000000000110000000110000000000010
1100100100100110000000110000000000010
1110110110110110000000110000000000010
1000000000000100000000010000000000010
1111111111111110000000111111111111110
00000000000001111000111100000000000000
0000000000000000100010000000000000000
0000000000000111100011110000000000000
0000000000000111000001110000000000000
0000000000000100101010010
0000000000000100101010010
0000000000000100101010010
0000000000000100000000010
0000000000000111100011110
00000000000000000222
